XXX444222XX
3H1B0B1 H0X
1   S B2  1
2H4  B3 H2X
4    B4   3
4H3 B4B3  2
X   B1B2  4
XXX3333XXXX