XXXXXXX2222XXXXXXX
X              H0X
X                X
X                X
X          UU    X
X                X
X    XX   XH1    X
X     X XX       X
X    SXX         X
X     X XX H2 L  X
X    XX   X   L  X
X                X
X    DD  RR      X
X     B2         X
X                X
X              H0X
X                X
XXXXXXX1111XXXXXXX
